1	2	3	4	5
3	3	2	2	1
4	5	3	0	1
3	5	1	0	3
4	4	3	0	1
4	4	3	0	1